############################################################
#..........................................................#
#..........................................................#
#..........................................................#
#..........................................................#
#.........#########........................................#
#.........#.......#........................................#
#.........#.......#........................................#
#.........#.......#......###########.......................#
#.........#.......#......#.........#.......................#
#.........#.......#......#.........#.......................#
#.........#.......#......#.........#.......................#
#.........#########......#.........#.......................#
#........................#.........#.......................#
#........................#.........#.......................#
#........................#.........#.......................#
#........................###########.......................#
#..........................................................#
#..........................................................#
#..........................................................#
#.......................................#############......#
#.......................................#...........#......#
#.......#########.......................#...........#......#
#.......#.......#.......................#...........#......#
#.......#.......#.......................#...........#......#
#.......#.......#.......................#...........#......#
#.......#.......#.......................#...........#......#
#.......#.......#.......................#...........#......#
#.......#.......#.......................#############......#
#.......#.......#..........................................#
#.......#########..........................................#
#..........................................................#
#..........................................................#
############################################################