#########################
#.......................#
#.......................#
#.......#####...........#
#.......#...#...........#
#.......#...#...........#
#.......#####...........#
#.......................#
#.............#####.....#
#.............#...#.....#
#.............#...#.....#
#.............#####.....#
#.......................#
#.......................#
#.......................#
#.......................#
#.......................#
#########################
