############################################################
#..........................................................#
#..@.......................................................#
#..........................................................#
#...........#######........................................#
#...........#.....#........................................#
#...........+.....#........................................#
#...........#.....#........................................#
#...........#######........................................#
#..........................................................#
#..........................................................#
#..........................................................#
#..........................................................#
#..........................................................#
#..........................................................#
#..........................................................#
#..........................................................#
#..........................................................#
#..........................................................#
############################################################
